R 2000 1000
NO ./texture/violet.xpm
SO ./texture/pink.xpm
WE ./texture/wallgray3.xpm
EA ./texture/wallgray2.xpm
S ./texture/collumn.xpm

F 192,192,192
C 200,200,200

1111111111111111111111111
10000000000000010000000S1
1000200001111101000011111
100000000100010100001
11111111111111111111
1111111111111111111111111
1000000001010101000011111
1111110001011101000000001
     10001000001000000001
1111110001111111000000001
1000000000000000000000001
1111111111111111111111111
