R 2000 2000
NO ./texture/violet.xpm
SO ./texture/pink.xpm
WE ./texture/wallgray3.xpm
EA ./texture/wallgray2.xpm
S ./texture/collumn.xpm

F 255,204,204
C 153,255,255

1111111111111111111111111
10000000000000010000000S1
1000200001111101000011111
1000000001000101000011111
1111111111111111111111111
1111111111111111111111111
1000000001010101000011111
1111110001011101000000001
1111111111111111111111111
